"filename", "language", "C#", "ASP.NET Razor", "MS SQL", "Markdown", "comment", "blank", "total"
"c:\Users\kursa\source\repos\MİniERP2_form_siifirdan\Database\Database_Documentation.md", "Markdown", 0, 0, 0, 29, 0, 7, 36
"c:\Users\kursa\source\repos\MİniERP2_form_siifirdan\Database\MiniERP_Clean.sql", "MS SQL", 0, 0, 6, 0, 0, 0, 6
"c:\Users\kursa\source\repos\MİniERP2_form_siifirdan\Database\README.md", "Markdown", 0, 0, 0, 51, 0, 16, 67
"c:\Users\kursa\source\repos\MİniERP2_form_siifirdan\Database\Update_Test_Users.sql", "MS SQL", 0, 0, -105, 0, -17, -29, -151
"c:\Users\kursa\source\repos\MİniERP2_form_siifirdan\Database\Update_Users_LastLoginDate.sql", "MS SQL", 0, 0, 0, 0, 0, 1, 1
"c:\Users\kursa\source\repos\MİniERP2_form_siifirdan\MiniERP.API\Controllers\StockController.cs", "C#", 23, 0, 0, 0, 6, 4, 33
"c:\Users\kursa\source\repos\MİniERP2_form_siifirdan\MiniERP.API\Controllers\UserController.cs", "C#", 29, 0, 0, 0, 6, 6, 41
"c:\Users\kursa\source\repos\MİniERP2_form_siifirdan\MiniERP.API\DTOs\UpdateStockDto.cs", "C#", 10, 0, 0, 0, 0, 1, 11
"c:\Users\kursa\source\repos\MİniERP2_form_siifirdan\MiniERP.API\DTOs\UserDto.cs", "C#", 3, 0, 0, 0, 1, 1, 5
"c:\Users\kursa\source\repos\MİniERP2_form_siifirdan\MiniERP.API\Models\User.cs", "C#", 1, 0, 0, 0, 0, 1, 2
"c:\Users\kursa\source\repos\MİniERP2_form_siifirdan\MiniERP.API\Services\IStockService.cs", "C#", 2, 0, 0, 0, 0, 0, 2
"c:\Users\kursa\source\repos\MİniERP2_form_siifirdan\MiniERP.API\Services\StockService.cs", "C#", 81, 0, 0, 0, 9, 16, 106
"c:\Users\kursa\source\repos\MİniERP2_form_siifirdan\MiniERP.API\Services\UserService.cs", "C#", 9, 0, 0, 0, 2, 1, 12
"c:\Users\kursa\source\repos\MİniERP2_form_siifirdan\MiniERP.Web\Controllers\CariAccountController.cs", "C#", 2, 0, 0, 0, 1, 1, 4
"c:\Users\kursa\source\repos\MİniERP2_form_siifirdan\MiniERP.Web\Controllers\PurchaseInvoiceController.cs", "C#", 11, 0, 0, 0, 2, 2, 15
"c:\Users\kursa\source\repos\MİniERP2_form_siifirdan\MiniERP.Web\Controllers\SalesInvoiceController.cs", "C#", 11, 0, 0, 0, 2, 2, 15
"c:\Users\kursa\source\repos\MİniERP2_form_siifirdan\MiniERP.Web\Controllers\StockController.cs", "C#", 138, 0, 0, 0, 7, 16, 161
"c:\Users\kursa\source\repos\MİniERP2_form_siifirdan\MiniERP.Web\Controllers\UserController.cs", "C#", 8, 0, 0, 0, 0, 1, 9
"c:\Users\kursa\source\repos\MİniERP2_form_siifirdan\MiniERP.Web\Helpers\CurrencyHelper.cs", "C#", 21, 0, 0, 0, 15, 5, 41
"c:\Users\kursa\source\repos\MİniERP2_form_siifirdan\MiniERP.Web\ModelBinders\DecimalModelBinder.cs", "C#", 12, 0, 0, 0, 21, 4, 37
"c:\Users\kursa\source\repos\MİniERP2_form_siifirdan\MiniERP.Web\Models\ProductModels.cs", "C#", 2, 0, 0, 0, 0, 0, 2
"c:\Users\kursa\source\repos\MİniERP2_form_siifirdan\MiniERP.Web\Models\StockModels.cs", "C#", 11, 0, 0, 0, 0, 1, 12
"c:\Users\kursa\source\repos\MİniERP2_form_siifirdan\MiniERP.Web\Models\UserModels.cs", "C#", 1, 0, 0, 0, 0, 1, 2
"c:\Users\kursa\source\repos\MİniERP2_form_siifirdan\MiniERP.Web\Program.cs", "C#", 1, 0, 0, 0, 0, 0, 1
"c:\Users\kursa\source\repos\MİniERP2_form_siifirdan\MiniERP.Web\Services\CariAccountService.cs", "C#", 16, 0, 0, 0, 2, 4, 22
"c:\Users\kursa\source\repos\MİniERP2_form_siifirdan\MiniERP.Web\Services\InvoiceNumberGeneratorService.cs", "C#", 46, 0, 0, 0, 27, 8, 81
"c:\Users\kursa\source\repos\MİniERP2_form_siifirdan\MiniERP.Web\Services\PaymentService.cs", "C#", 0, 0, 0, 0, 0, 2, 2
"c:\Users\kursa\source\repos\MİniERP2_form_siifirdan\MiniERP.Web\Services\PurchaseInvoiceService.cs", "C#", 38, 0, 0, 0, 2, 8, 48
"c:\Users\kursa\source\repos\MİniERP2_form_siifirdan\MiniERP.Web\Services\SalesInvoiceService.cs", "C#", 38, 0, 0, 0, 2, 8, 48
"c:\Users\kursa\source\repos\MİniERP2_form_siifirdan\MiniERP.Web\Services\StockService.cs", "C#", 15, 0, 0, 0, 4, 2, 21
"c:\Users\kursa\source\repos\MİniERP2_form_siifirdan\MiniERP.Web\Services\UserService.cs", "C#", 44, 0, 0, 0, 3, 6, 53
"c:\Users\kursa\source\repos\MİniERP2_form_siifirdan\MiniERP.Web\Views\ApiTest\Index.cshtml", "ASP.NET Razor", 0, 0, 0, 0, 0, 1, 1
"c:\Users\kursa\source\repos\MİniERP2_form_siifirdan\MiniERP.Web\Views\ApiTest\TestResult.cshtml", "ASP.NET Razor", 0, 0, 0, 0, 0, 1, 1
"c:\Users\kursa\source\repos\MİniERP2_form_siifirdan\MiniERP.Web\Views\Auth\AccessDenied.cshtml", "ASP.NET Razor", 0, 0, 0, 0, 0, 1, 1
"c:\Users\kursa\source\repos\MİniERP2_form_siifirdan\MiniERP.Web\Views\Auth\Login.cshtml", "ASP.NET Razor", 0, 0, 0, 0, 0, 1, 1
"c:\Users\kursa\source\repos\MİniERP2_form_siifirdan\MiniERP.Web\Views\CariAccount\Create.cshtml", "ASP.NET Razor", 0, 0, 0, 0, 0, 1, 1
"c:\Users\kursa\source\repos\MİniERP2_form_siifirdan\MiniERP.Web\Views\CariAccount\CustomerSupplierList.cshtml", "ASP.NET Razor", 0, 0, 0, 0, 0, 1, 1
"c:\Users\kursa\source\repos\MİniERP2_form_siifirdan\MiniERP.Web\Views\CariAccount\Delete.cshtml", "ASP.NET Razor", 0, 0, 0, 0, 0, 1, 1
"c:\Users\kursa\source\repos\MİniERP2_form_siifirdan\MiniERP.Web\Views\CariAccount\Details.cshtml", "ASP.NET Razor", 0, 0, 0, 0, 0, 1, 1
"c:\Users\kursa\source\repos\MİniERP2_form_siifirdan\MiniERP.Web\Views\CariAccount\Edit.cshtml", "ASP.NET Razor", 0, 0, 0, 0, 0, 1, 1
"c:\Users\kursa\source\repos\MİniERP2_form_siifirdan\MiniERP.Web\Views\CariAccount\Index.cshtml", "ASP.NET Razor", 0, 0, 0, 0, 0, 1, 1
"c:\Users\kursa\source\repos\MİniERP2_form_siifirdan\MiniERP.Web\Views\CariAccount\Statement.cshtml", "ASP.NET Razor", 0, 0, 0, 0, 0, 1, 1
"c:\Users\kursa\source\repos\MİniERP2_form_siifirdan\MiniERP.Web\Views\CariAccount\Transactions.cshtml", "ASP.NET Razor", 0, 0, 0, 0, 0, 1, 1
"c:\Users\kursa\source\repos\MİniERP2_form_siifirdan\MiniERP.Web\Views\Dashboard\Index.cshtml", "ASP.NET Razor", 0, 0, 0, 0, 0, 1, 1
"c:\Users\kursa\source\repos\MİniERP2_form_siifirdan\MiniERP.Web\Views\Home\Index.cshtml", "ASP.NET Razor", 0, 0, 0, 0, 0, 1, 1
"c:\Users\kursa\source\repos\MİniERP2_form_siifirdan\MiniERP.Web\Views\Home\Privacy.cshtml", "ASP.NET Razor", 0, 0, 0, 0, 0, 1, 1
"c:\Users\kursa\source\repos\MİniERP2_form_siifirdan\MiniERP.Web\Views\Product\Create.cshtml", "ASP.NET Razor", 0, 20, 0, 0, 0, 2, 22
"c:\Users\kursa\source\repos\MİniERP2_form_siifirdan\MiniERP.Web\Views\Product\Details.cshtml", "ASP.NET Razor", 0, 0, 0, 0, 0, 1, 1
"c:\Users\kursa\source\repos\MİniERP2_form_siifirdan\MiniERP.Web\Views\Product\Edit.cshtml", "ASP.NET Razor", 0, 20, 0, 0, 0, 2, 22
"c:\Users\kursa\source\repos\MİniERP2_form_siifirdan\MiniERP.Web\Views\Product\Index.cshtml", "ASP.NET Razor", 0, 96, 0, 0, 0, 4, 100
"c:\Users\kursa\source\repos\MİniERP2_form_siifirdan\MiniERP.Web\Views\PurchaseInvoice\Create.cshtml", "ASP.NET Razor", 0, 19, 0, 0, 0, 3, 22
"c:\Users\kursa\source\repos\MİniERP2_form_siifirdan\MiniERP.Web\Views\PurchaseInvoice\Delete.cshtml", "ASP.NET Razor", 0, 0, 0, 0, 0, 1, 1
"c:\Users\kursa\source\repos\MİniERP2_form_siifirdan\MiniERP.Web\Views\PurchaseInvoice\Details.cshtml", "ASP.NET Razor", 0, 41, 0, 0, 0, 8, 49
"c:\Users\kursa\source\repos\MİniERP2_form_siifirdan\MiniERP.Web\Views\PurchaseInvoice\Edit.cshtml", "ASP.NET Razor", 0, 0, 0, 0, 0, 1, 1
"c:\Users\kursa\source\repos\MİniERP2_form_siifirdan\MiniERP.Web\Views\PurchaseInvoice\Index.cshtml", "ASP.NET Razor", 0, 47, 0, 0, 0, 5, 52
"c:\Users\kursa\source\repos\MİniERP2_form_siifirdan\MiniERP.Web\Views\SalesInvoice\Create.cshtml", "ASP.NET Razor", 0, 28, 0, 0, 0, 4, 32
"c:\Users\kursa\source\repos\MİniERP2_form_siifirdan\MiniERP.Web\Views\SalesInvoice\Delete.cshtml", "ASP.NET Razor", 0, 0, 0, 0, 0, 1, 1
"c:\Users\kursa\source\repos\MİniERP2_form_siifirdan\MiniERP.Web\Views\SalesInvoice\Details.cshtml", "ASP.NET Razor", 0, 41, 0, 0, 0, 8, 49
"c:\Users\kursa\source\repos\MİniERP2_form_siifirdan\MiniERP.Web\Views\SalesInvoice\Edit.cshtml", "ASP.NET Razor", 0, 0, 0, 0, 0, 1, 1
"c:\Users\kursa\source\repos\MİniERP2_form_siifirdan\MiniERP.Web\Views\SalesInvoice\Index.cshtml", "ASP.NET Razor", 0, 47, 0, 0, 0, 5, 52
"c:\Users\kursa\source\repos\MİniERP2_form_siifirdan\MiniERP.Web\Views\Shared\Error.cshtml", "ASP.NET Razor", 0, 0, 0, 0, 0, 1, 1
"c:\Users\kursa\source\repos\MİniERP2_form_siifirdan\MiniERP.Web\Views\Shared\_Layout.cshtml", "ASP.NET Razor", 0, 0, 0, 0, 0, 1, 1
"c:\Users\kursa\source\repos\MİniERP2_form_siifirdan\MiniERP.Web\Views\Shared\_ValidationScriptsPartial.cshtml", "ASP.NET Razor", 0, 0, 0, 0, 0, 1, 1
"c:\Users\kursa\source\repos\MİniERP2_form_siifirdan\MiniERP.Web\Views\Stock\Create.cshtml", "ASP.NET Razor", 0, 0, 0, 0, 0, 1, 1
"c:\Users\kursa\source\repos\MİniERP2_form_siifirdan\MiniERP.Web\Views\Stock\Critical.cshtml", "ASP.NET Razor", 0, 0, 0, 0, 0, 1, 1
"c:\Users\kursa\source\repos\MİniERP2_form_siifirdan\MiniERP.Web\Views\Stock\Delete.cshtml", "ASP.NET Razor", 0, 0, 0, 0, 0, 1, 1
"c:\Users\kursa\source\repos\MİniERP2_form_siifirdan\MiniERP.Web\Views\Stock\Details.cshtml", "ASP.NET Razor", 0, -9, 0, 0, 0, 4, -5
"c:\Users\kursa\source\repos\MİniERP2_form_siifirdan\MiniERP.Web\Views\Stock\Edit.cshtml", "ASP.NET Razor", 0, 56, 0, 0, 0, 5, 61
"c:\Users\kursa\source\repos\MİniERP2_form_siifirdan\MiniERP.Web\Views\Stock\Index.cshtml", "ASP.NET Razor", 0, 0, 0, 0, 0, 1, 1
"c:\Users\kursa\source\repos\MİniERP2_form_siifirdan\MiniERP.Web\Views\Stock\OutOfStock.cshtml", "ASP.NET Razor", 0, 0, 0, 0, 0, 1, 1
"c:\Users\kursa\source\repos\MİniERP2_form_siifirdan\MiniERP.Web\Views\Stock\Report.cshtml", "ASP.NET Razor", 0, 0, 0, 0, 0, 1, 1
"c:\Users\kursa\source\repos\MİniERP2_form_siifirdan\MiniERP.Web\Views\Stock\Summary.cshtml", "ASP.NET Razor", 0, 0, 0, 0, 0, 1, 1
"c:\Users\kursa\source\repos\MİniERP2_form_siifirdan\MiniERP.Web\Views\Stock\TransactionDetails.cshtml", "ASP.NET Razor", 0, 0, 0, 0, 0, 1, 1
"c:\Users\kursa\source\repos\MİniERP2_form_siifirdan\MiniERP.Web\Views\Stock\Transactions.cshtml", "ASP.NET Razor", 0, 15, 0, 0, 0, 1, 16
"c:\Users\kursa\source\repos\MİniERP2_form_siifirdan\MiniERP.Web\Views\Stock\Transfer.cshtml", "ASP.NET Razor", 0, 0, 0, 0, 0, 1, 1
"c:\Users\kursa\source\repos\MİniERP2_form_siifirdan\MiniERP.Web\Views\Stock\UpdateStock.cshtml", "ASP.NET Razor", 0, 9, 0, 0, 0, 1, 10
"c:\Users\kursa\source\repos\MİniERP2_form_siifirdan\MiniERP.Web\Views\User\Create.cshtml", "ASP.NET Razor", 0, 236, 0, 0, 0, 23, 259
"c:\Users\kursa\source\repos\MİniERP2_form_siifirdan\MiniERP.Web\Views\User\Details.cshtml", "ASP.NET Razor", 0, 210, 0, 0, 0, 15, 225
"c:\Users\kursa\source\repos\MİniERP2_form_siifirdan\MiniERP.Web\Views\User\Edit.cshtml", "ASP.NET Razor", 0, 184, 0, 0, 0, 16, 200
"c:\Users\kursa\source\repos\MİniERP2_form_siifirdan\MiniERP.Web\Views\User\Index.cshtml", "ASP.NET Razor", 0, 23, 0, 0, 0, 4, 27
"c:\Users\kursa\source\repos\MİniERP2_form_siifirdan\MiniERP.Web\Views\_ViewImports.cshtml", "ASP.NET Razor", 0, 1, 0, 0, 0, 1, 2
"c:\Users\kursa\source\repos\MİniERP2_form_siifirdan\MiniERP.Web\Views\_ViewStart.cshtml", "ASP.NET Razor", 0, 0, 0, 0, 0, 1, 1
"c:\Users\kursa\source\repos\MİniERP2_form_siifirdan\MiniERP.WinForms\DTOs\CariAccountDto.cs", "C#", -3, 0, 0, 0, 0, 2, -1
"c:\Users\kursa\source\repos\MİniERP2_form_siifirdan\MiniERP.WinForms\DTOs\CommonDto.cs", "C#", 20, 0, 0, 0, 0, 4, 24
"c:\Users\kursa\source\repos\MİniERP2_form_siifirdan\MiniERP.WinForms\DTOs\DashboardDto.cs", "C#", 22, 0, 0, 0, 0, 2, 24
"c:\Users\kursa\source\repos\MİniERP2_form_siifirdan\MiniERP.WinForms\DTOs\ProductDto.cs", "C#", 0, 0, 0, 0, 0, 2, 2
"c:\Users\kursa\source\repos\MİniERP2_form_siifirdan\MiniERP.WinForms\DTOs\PurchaseInvoiceDto.cs", "C#", 2, 0, 0, 0, 2, 2, 6
"c:\Users\kursa\source\repos\MİniERP2_form_siifirdan\MiniERP.WinForms\DTOs\SalesInvoiceDto.cs", "C#", 0, 0, 0, 0, 0, 2, 2
"c:\Users\kursa\source\repos\MİniERP2_form_siifirdan\MiniERP.WinForms\DTOs\StockDto.cs", "C#", 8, 0, 0, 0, 0, 2, 10
"c:\Users\kursa\source\repos\MİniERP2_form_siifirdan\MiniERP.WinForms\DTOs\StockInfoDto.cs", "C#", 0, 0, 0, 0, 0, 1, 1
"c:\Users\kursa\source\repos\MİniERP2_form_siifirdan\MiniERP.WinForms\DTOs\UpdateStockDto.cs", "C#", 13, 0, 0, 0, 0, 1, 14
"c:\Users\kursa\source\repos\MİniERP2_form_siifirdan\MiniERP.WinForms\DTOs\UserDto.cs", "C#", 40, 0, 0, 0, 1, 7, 48
"c:\Users\kursa\source\repos\MİniERP2_form_siifirdan\MiniERP.WinForms\DTOs\WarehouseDto.cs", "C#", 0, 0, 0, 0, 0, 2, 2
"c:\Users\kursa\source\repos\MİniERP2_form_siifirdan\MiniERP.WinForms\Forms\AlisFaturaDetayForm.Designer.cs", "C#", 17, 0, 0, 0, 3, 2, 22
"c:\Users\kursa\source\repos\MİniERP2_form_siifirdan\MiniERP.WinForms\Forms\AlisFaturaDetayForm.cs", "C#", 50, 0, 0, 0, 8, 10, 68
"c:\Users\kursa\source\repos\MİniERP2_form_siifirdan\MiniERP.WinForms\Forms\AlisFaturaDuzenleForm.Designer.cs", "C#", 0, 0, 0, 0, 0, 2, 2
"c:\Users\kursa\source\repos\MİniERP2_form_siifirdan\MiniERP.WinForms\Forms\AlisFaturaDuzenleForm.cs", "C#", 229, 0, 0, 0, 27, 35, 291
"c:\Users\kursa\source\repos\MİniERP2_form_siifirdan\MiniERP.WinForms\Forms\AlisFaturaSilForm.Designer.cs", "C#", 463, 0, 0, 0, 113, 8, 584
"c:\Users\kursa\source\repos\MİniERP2_form_siifirdan\MiniERP.WinForms\Forms\AlisFaturaSilForm.cs", "C#", 213, 0, 0, 0, 10, 34, 257
"c:\Users\kursa\source\repos\MİniERP2_form_siifirdan\MiniERP.WinForms\Forms\AlisFaturalariForm.Designer.cs", "C#", 0, 0, 0, 0, 0, 2, 2
"c:\Users\kursa\source\repos\MİniERP2_form_siifirdan\MiniERP.WinForms\Forms\AlisFaturalariForm.cs", "C#", 28, 0, 0, 0, 2, 9, 39
"c:\Users\kursa\source\repos\MİniERP2_form_siifirdan\MiniERP.WinForms\Forms\AlisFaturasiEkleForm.Designer.cs", "C#", 3, 0, 0, 0, 1, 2, 6
"c:\Users\kursa\source\repos\MİniERP2_form_siifirdan\MiniERP.WinForms\Forms\AlisFaturasiEkleForm.cs", "C#", 7, 0, 0, 0, 6, 2, 15
"c:\Users\kursa\source\repos\MİniERP2_form_siifirdan\MiniERP.WinForms\Forms\BaseForm.cs", "C#", 0, 0, 0, 0, 0, 1, 1
"c:\Users\kursa\source\repos\MİniERP2_form_siifirdan\MiniERP.WinForms\Forms\CariDetayForm.Designer.cs", "C#", 0, 0, 0, 0, 0, 2, 2
"c:\Users\kursa\source\repos\MİniERP2_form_siifirdan\MiniERP.WinForms\Forms\CariDetayForm.cs", "C#", -2, 0, 0, 0, 0, 2, 0
"c:\Users\kursa\source\repos\MİniERP2_form_siifirdan\MiniERP.WinForms\Forms\CariDuzenleForm.Designer.cs", "C#", 1, 0, 0, 0, 0, 2, 3
"c:\Users\kursa\source\repos\MİniERP2_form_siifirdan\MiniERP.WinForms\Forms\CariDuzenleForm.cs", "C#", 0, 0, 0, 0, 0, 2, 2
"c:\Users\kursa\source\repos\MİniERP2_form_siifirdan\MiniERP.WinForms\Forms\CariEkleForm.Designer.cs", "C#", 0, 0, 0, 0, 0, 2, 2
"c:\Users\kursa\source\repos\MİniERP2_form_siifirdan\MiniERP.WinForms\Forms\CariEkleForm.cs", "C#", 0, 0, 0, 0, 0, 2, 2
"c:\Users\kursa\source\repos\MİniERP2_form_siifirdan\MiniERP.WinForms\Forms\CariEkstreForm.Designer.cs", "C#", 0, 0, 0, 0, 0, 2, 2
"c:\Users\kursa\source\repos\MİniERP2_form_siifirdan\MiniERP.WinForms\Forms\CariEkstreForm.cs", "C#", 0, 0, 0, 0, 0, 2, 2
"c:\Users\kursa\source\repos\MİniERP2_form_siifirdan\MiniERP.WinForms\Forms\CariHareketleriForm.Designer.cs", "C#", 0, 0, 0, 0, 0, 2, 2
"c:\Users\kursa\source\repos\MİniERP2_form_siifirdan\MiniERP.WinForms\Forms\CariHareketleriForm.cs", "C#", 0, 0, 0, 0, 0, 2, 2
"c:\Users\kursa\source\repos\MİniERP2_form_siifirdan\MiniERP.WinForms\Forms\CariHesaplarForm.Designer.cs", "C#", 0, 0, 0, 0, 0, 2, 2
"c:\Users\kursa\source\repos\MİniERP2_form_siifirdan\MiniERP.WinForms\Forms\CariHesaplarForm.cs", "C#", -9, 0, 0, 0, 0, 1, -8
"c:\Users\kursa\source\repos\MİniERP2_form_siifirdan\MiniERP.WinForms\Forms\CariHesaplarFormNew.cs", "C#", 0, 0, 0, 0, 0, 1, 1
"c:\Users\kursa\source\repos\MİniERP2_form_siifirdan\MiniERP.WinForms\Forms\CariSilForm.Designer.cs", "C#", 0, 0, 0, 0, 0, 2, 2
"c:\Users\kursa\source\repos\MİniERP2_form_siifirdan\MiniERP.WinForms\Forms\CariSilForm.cs", "C#", 0, 0, 0, 0, 0, 2, 2
"c:\Users\kursa\source\repos\MİniERP2_form_siifirdan\MiniERP.WinForms\Forms\KullaniciDetayForm.Designer.cs", "C#", 290, 0, 0, 0, 80, 6, 376
"c:\Users\kursa\source\repos\MİniERP2_form_siifirdan\MiniERP.WinForms\Forms\KullaniciDetayForm.cs", "C#", 128, 0, 0, 0, 6, 19, 153
"c:\Users\kursa\source\repos\MİniERP2_form_siifirdan\MiniERP.WinForms\Forms\KullaniciDuzenleForm.Designer.cs", "C#", 300, 0, 0, 0, 86, 7, 393
"c:\Users\kursa\source\repos\MİniERP2_form_siifirdan\MiniERP.WinForms\Forms\KullaniciDuzenleForm.cs", "C#", 183, 0, 0, 0, 4, 20, 207
"c:\Users\kursa\source\repos\MİniERP2_form_siifirdan\MiniERP.WinForms\Forms\KullaniciEkleForm.Designer.cs", "C#", 288, 0, 0, 0, 83, 6, 377
"c:\Users\kursa\source\repos\MİniERP2_form_siifirdan\MiniERP.WinForms\Forms\KullaniciEkleForm.cs", "C#", 204, 0, 0, 0, 11, 29, 244
"c:\Users\kursa\source\repos\MİniERP2_form_siifirdan\MiniERP.WinForms\Forms\KullaniciYonetimiForm.Designer.cs", "C#", 273, 0, 0, 0, 65, 6, 344
"c:\Users\kursa\source\repos\MİniERP2_form_siifirdan\MiniERP.WinForms\Forms\KullaniciYonetimiForm.cs", "C#", 415, 0, 0, 0, 20, 66, 501
"c:\Users\kursa\source\repos\MİniERP2_form_siifirdan\MiniERP.WinForms\Forms\LoginForm.Designer.cs", "C#", 0, 0, 0, 0, 0, 2, 2
"c:\Users\kursa\source\repos\MİniERP2_form_siifirdan\MiniERP.WinForms\Forms\LoginForm.cs", "C#", 0, 0, 0, 0, 0, 2, 2
"c:\Users\kursa\source\repos\MİniERP2_form_siifirdan\MiniERP.WinForms\Forms\MainForm.Designer.cs", "C#", 0, 0, 0, 0, 0, 2, 2
"c:\Users\kursa\source\repos\MİniERP2_form_siifirdan\MiniERP.WinForms\Forms\MainForm.cs", "C#", 156, 0, 0, 0, 16, 16, 188
"c:\Users\kursa\source\repos\MİniERP2_form_siifirdan\MiniERP.WinForms\Forms\SatisFaturaDetayForm.Designer.cs", "C#", 0, 0, 0, 0, 0, 2, 2
"c:\Users\kursa\source\repos\MİniERP2_form_siifirdan\MiniERP.WinForms\Forms\SatisFaturaDetayForm.cs", "C#", 23, 0, 0, 0, 5, 7, 35
"c:\Users\kursa\source\repos\MİniERP2_form_siifirdan\MiniERP.WinForms\Forms\SatisFaturalariForm.Designer.cs", "C#", 0, 0, 0, 0, 0, 2, 2
"c:\Users\kursa\source\repos\MİniERP2_form_siifirdan\MiniERP.WinForms\Forms\SatisFaturalariForm.cs", "C#", 60, 0, 0, 0, 2, 6, 68
"c:\Users\kursa\source\repos\MİniERP2_form_siifirdan\MiniERP.WinForms\Forms\SatisFaturasiEkleForm.Designer.cs", "C#", 0, 0, 0, 0, 0, 2, 2
"c:\Users\kursa\source\repos\MİniERP2_form_siifirdan\MiniERP.WinForms\Forms\SatisFaturasiEkleForm.cs", "C#", 8, 0, 0, 0, 0, 2, 10
"c:\Users\kursa\source\repos\MİniERP2_form_siifirdan\MiniERP.WinForms\Forms\SatisFaturasiEkleFormNew.cs", "C#", 0, 0, 0, 0, 0, 1, 1
"c:\Users\kursa\source\repos\MİniERP2_form_siifirdan\MiniERP.WinForms\Forms\SatisFaturasiSilForm.Designer.cs", "C#", 0, 0, 0, 0, 0, 2, 2
"c:\Users\kursa\source\repos\MİniERP2_form_siifirdan\MiniERP.WinForms\Forms\SatisFaturasiSilForm.cs", "C#", 0, 0, 0, 0, 0, 2, 2
"c:\Users\kursa\source\repos\MİniERP2_form_siifirdan\MiniERP.WinForms\Forms\StokDetayForm.Designer.cs", "C#", 718, 0, 0, 0, 174, 6, 898
"c:\Users\kursa\source\repos\MİniERP2_form_siifirdan\MiniERP.WinForms\Forms\StokDetayForm.cs", "C#", 265, 0, 0, 0, 27, 47, 339
"c:\Users\kursa\source\repos\MİniERP2_form_siifirdan\MiniERP.WinForms\Forms\StokGuncelleForm.Designer.cs", "C#", 0, 0, 0, 0, 0, 2, 2
"c:\Users\kursa\source\repos\MİniERP2_form_siifirdan\MiniERP.WinForms\Forms\StokGuncelleForm.cs", "C#", 0, 0, 0, 0, 0, 2, 2
"c:\Users\kursa\source\repos\MİniERP2_form_siifirdan\MiniERP.WinForms\Forms\StokGuncellemeForm.Designer.cs", "C#", 0, 0, 0, 0, 0, 2, 2
"c:\Users\kursa\source\repos\MİniERP2_form_siifirdan\MiniERP.WinForms\Forms\StokGuncellemeForm.cs", "C#", 146, 0, 0, 0, 16, 35, 197
"c:\Users\kursa\source\repos\MİniERP2_form_siifirdan\MiniERP.WinForms\Forms\StokKartiDuzenleForm.Designer.cs", "C#", 344, 0, 0, 0, 107, 6, 457
"c:\Users\kursa\source\repos\MİniERP2_form_siifirdan\MiniERP.WinForms\Forms\StokKartiDuzenleForm.cs", "C#", 133, 0, 0, 0, 7, 24, 164
"c:\Users\kursa\source\repos\MİniERP2_form_siifirdan\MiniERP.WinForms\Forms\StokKartiEkleForm.Designer.cs", "C#", 0, 0, 0, 0, 0, 2, 2
"c:\Users\kursa\source\repos\MİniERP2_form_siifirdan\MiniERP.WinForms\Forms\StokKartiEkleForm.cs", "C#", -6, 0, 0, 0, 0, 0, -6
"c:\Users\kursa\source\repos\MİniERP2_form_siifirdan\MiniERP.WinForms\Forms\StokKartiEkleFormNew.Designer.cs", "C#", 0, 0, 0, 0, 0, 2, 2
"c:\Users\kursa\source\repos\MİniERP2_form_siifirdan\MiniERP.WinForms\Forms\StokKartiEkleFormNew.cs", "C#", 0, 0, 0, 0, 0, 2, 2
"c:\Users\kursa\source\repos\MİniERP2_form_siifirdan\MiniERP.WinForms\Forms\StokPlaceholderForms.Designer.cs", "C#", 0, 0, 0, 0, 0, 2, 2
"c:\Users\kursa\source\repos\MİniERP2_form_siifirdan\MiniERP.WinForms\Forms\StokPlaceholderForms.cs", "C#", 0, 0, 0, 0, 0, 2, 2
"c:\Users\kursa\source\repos\MİniERP2_form_siifirdan\MiniERP.WinForms\Forms\StokTransferiForm.Designer.cs", "C#", 0, 0, 0, 0, 0, 2, 2
"c:\Users\kursa\source\repos\MİniERP2_form_siifirdan\MiniERP.WinForms\Forms\StokTransferiForm.cs", "C#", 99, 0, 0, 0, 12, 19, 130
"c:\Users\kursa\source\repos\MİniERP2_form_siifirdan\MiniERP.WinForms\Forms\StokTransferiForm_New.cs", "C#", 0, 0, 0, 0, 0, 2, 2
"c:\Users\kursa\source\repos\MİniERP2_form_siifirdan\MiniERP.WinForms\Forms\StokYonetimiForm.Designer.cs", "C#", -12, 0, 0, 0, -6, 2, -16
"c:\Users\kursa\source\repos\MİniERP2_form_siifirdan\MiniERP.WinForms\Forms\StokYonetimiForm.cs", "C#", -65, 0, 0, 0, -10, 0, -75
"c:\Users\kursa\source\repos\MİniERP2_form_siifirdan\MiniERP.WinForms\Forms\StokYonetimiFormNew.cs", "C#", 0, 0, 0, 0, 0, 1, 1
"c:\Users\kursa\source\repos\MİniERP2_form_siifirdan\MiniERP.WinForms\Forms\UrunDetayForm.Designer.cs", "C#", 0, 0, 0, 0, 0, 2, 2
"c:\Users\kursa\source\repos\MİniERP2_form_siifirdan\MiniERP.WinForms\Forms\UrunDetayForm.cs", "C#", 0, 0, 0, 0, 0, 2, 2
"c:\Users\kursa\source\repos\MİniERP2_form_siifirdan\MiniERP.WinForms\Forms\UrunDuzenleForm.Designer.cs", "C#", 0, 0, 0, 0, 0, 2, 2
"c:\Users\kursa\source\repos\MİniERP2_form_siifirdan\MiniERP.WinForms\Forms\UrunDuzenleForm.cs", "C#", 3, 0, 0, 0, 2, 4, 9
"c:\Users\kursa\source\repos\MİniERP2_form_siifirdan\MiniERP.WinForms\Forms\UrunEkleForm.Designer.cs", "C#", 0, 0, 0, 0, 0, 2, 2
"c:\Users\kursa\source\repos\MİniERP2_form_siifirdan\MiniERP.WinForms\Forms\UrunEkleForm.cs", "C#", 0, 0, 0, 0, 0, 2, 2
"c:\Users\kursa\source\repos\MİniERP2_form_siifirdan\MiniERP.WinForms\Forms\UrunlerForm.Designer.cs", "C#", 0, 0, 0, 0, 0, 2, 2
"c:\Users\kursa\source\repos\MİniERP2_form_siifirdan\MiniERP.WinForms\Forms\UrunlerForm.cs", "C#", 18, 0, 0, 0, 2, 6, 26
"c:\Users\kursa\source\repos\MİniERP2_form_siifirdan\MiniERP.WinForms\Helpers\CurrencyHelper.cs", "C#", 18, 0, 0, 0, 9, 6, 33
"c:\Users\kursa\source\repos\MİniERP2_form_siifirdan\MiniERP.WinForms\Helpers\DataGridViewHelper.cs", "C#", 0, 0, 0, 0, 0, 1, 1
"c:\Users\kursa\source\repos\MİniERP2_form_siifirdan\MiniERP.WinForms\Helpers\PaginationHelper.cs", "C#", 0, 0, 0, 0, 0, 1, 1
"c:\Users\kursa\source\repos\MİniERP2_form_siifirdan\MiniERP.WinForms\Helpers\ValidationHelper.cs", "C#", 0, 0, 0, 0, 0, 1, 1
"c:\Users\kursa\source\repos\MİniERP2_form_siifirdan\MiniERP.WinForms\Models\PurchaseInvoiceDetailItem.cs", "C#", 66, 0, 0, 0, 0, 15, 81
"c:\Users\kursa\source\repos\MİniERP2_form_siifirdan\MiniERP.WinForms\Program.cs", "C#", 0, 0, 0, 0, 0, 2, 2
"c:\Users\kursa\source\repos\MİniERP2_form_siifirdan\MiniERP.WinForms\Services\ApiService.cs", "C#", 0, 0, 0, 0, 0, 2, 2
"c:\Users\kursa\source\repos\MİniERP2_form_siifirdan\MiniERP.WinForms\Services\InvoiceNumberGeneratorService.cs", "C#", 42, 0, 0, 0, 22, 7, 71
"c:\Users\kursa\source\repos\MİniERP2_form_siifirdan\MiniERP.WinForms\Services\LoadingManager.cs", "C#", 0, 0, 0, 0, 0, 1, 1
"c:\Users\kursa\source\repos\MİniERP2_form_siifirdan\MiniERP.WinForms\Services\NotificationManager.cs", "C#", 0, 0, 0, 0, 0, 1, 1
"c:\Users\kursa\source\repos\MİniERP2_form_siifirdan\MiniERP.WinForms\Services\SessionManager.cs", "C#", 0, 0, 0, 0, 0, 1, 1
"c:\Users\kursa\source\repos\MİniERP2_form_siifirdan\MiniERP.WinForms\Services\StockService.cs", "C#", 12, 0, 0, 0, 1, 4, 17
"c:\Users\kursa\source\repos\MİniERP2_form_siifirdan\MiniERP.WinForms\Services\TokenManager.cs", "C#", 0, 0, 0, 0, 0, 2, 2
"c:\Users\kursa\source\repos\MİniERP2_form_siifirdan\MiniERP.WinForms\Services\UserService.cs", "C#", 168, 0, 0, 0, 0, 19, 187
"Total", "-", 5952, 1084, -99, 80, 1009, 854, 8880