"filename", "language", "C#", "comment", "blank", "total"
"c:\Users\kursa\source\repos\MİniERP2_form_siifirdan\MiniERP.API\DTOs\InvoiceDto.cs", "C#", 1, 0, 0, 1
"c:\Users\kursa\source\repos\MİniERP2_form_siifirdan\MiniERP.WinForms\DTOs\ProductDto.cs", "C#", 1, 0, 0, 1
"c:\Users\kursa\source\repos\MİniERP2_form_siifirdan\MiniERP.WinForms\DTOs\PurchaseInvoiceDto.cs", "C#", 82, 0, 7, 89
"c:\Users\kursa\source\repos\MİniERP2_form_siifirdan\MiniERP.WinForms\DTOs\SalesInvoiceDto.cs", "C#", 86, 0, 8, 94
"c:\Users\kursa\source\repos\MİniERP2_form_siifirdan\MiniERP.WinForms\DTOs\WarehouseDto.cs", "C#", 27, 0, 3, 30
"c:\Users\kursa\source\repos\MİniERP2_form_siifirdan\MiniERP.WinForms\Forms\AlisFaturaDetayForm.Designer.cs", "C#", 604, 143, 7, 754
"c:\Users\kursa\source\repos\MİniERP2_form_siifirdan\MiniERP.WinForms\Forms\AlisFaturaDetayForm.cs", "C#", 258, 27, 42, 327
"c:\Users\kursa\source\repos\MİniERP2_form_siifirdan\MiniERP.WinForms\Forms\AlisFaturaDuzenleForm.Designer.cs", "C#", 452, 116, 7, 575
"c:\Users\kursa\source\repos\MİniERP2_form_siifirdan\MiniERP.WinForms\Forms\AlisFaturaDuzenleForm.cs", "C#", 385, 22, 65, 472
"c:\Users\kursa\source\repos\MİniERP2_form_siifirdan\MiniERP.WinForms\Forms\AlisFaturalariForm.Designer.cs", "C#", 412, 104, 7, 523
"c:\Users\kursa\source\repos\MİniERP2_form_siifirdan\MiniERP.WinForms\Forms\AlisFaturalariForm.cs", "C#", 393, 22, 54, 469
"c:\Users\kursa\source\repos\MİniERP2_form_siifirdan\MiniERP.WinForms\Forms\AlisFaturasiEkleForm.Designer.cs", "C#", 439, 110, 7, 556
"c:\Users\kursa\source\repos\MİniERP2_form_siifirdan\MiniERP.WinForms\Forms\AlisFaturasiEkleForm.cs", "C#", 509, 39, 84, 632
"c:\Users\kursa\source\repos\MİniERP2_form_siifirdan\MiniERP.WinForms\Forms\MainForm.cs", "C#", 2, 0, 0, 2
"c:\Users\kursa\source\repos\MİniERP2_form_siifirdan\MiniERP.WinForms\Forms\SatisFaturaDetayForm.Designer.cs", "C#", 603, 143, 7, 753
"c:\Users\kursa\source\repos\MİniERP2_form_siifirdan\MiniERP.WinForms\Forms\SatisFaturaDetayForm.cs", "C#", 348, 36, 57, 441
"c:\Users\kursa\source\repos\MİniERP2_form_siifirdan\MiniERP.WinForms\Forms\SatisFaturalariForm.Designer.cs", "C#", 399, 104, 7, 510
"c:\Users\kursa\source\repos\MİniERP2_form_siifirdan\MiniERP.WinForms\Forms\SatisFaturalariForm.cs", "C#", 450, 28, 69, 547
"c:\Users\kursa\source\repos\MİniERP2_form_siifirdan\MiniERP.WinForms\Forms\SatisFaturasiEkleForm.Designer.cs", "C#", 460, 119, 7, 586
"c:\Users\kursa\source\repos\MİniERP2_form_siifirdan\MiniERP.WinForms\Forms\SatisFaturasiEkleForm.cs", "C#", 509, 32, 72, 613
"c:\Users\kursa\source\repos\MİniERP2_form_siifirdan\MiniERP.WinForms\Forms\SatisFaturasiSilForm.Designer.cs", "C#", 614, 128, 7, 749
"c:\Users\kursa\source\repos\MİniERP2_form_siifirdan\MiniERP.WinForms\Forms\SatisFaturasiSilForm.cs", "C#", 191, 9, 26, 226
"c:\Users\kursa\source\repos\MİniERP2_form_siifirdan\MiniERP.WinForms\Forms\StokGuncelleForm.cs", "C#", 5, 0, 0, 5
"c:\Users\kursa\source\repos\MİniERP2_form_siifirdan\MiniERP.WinForms\Forms\StokGuncellemeForm.Designer.cs", "C#", 454, 104, 7, 565
"c:\Users\kursa\source\repos\MİniERP2_form_siifirdan\MiniERP.WinForms\Forms\StokGuncellemeForm.cs", "C#", 203, 11, 31, 245
"c:\Users\kursa\source\repos\MİniERP2_form_siifirdan\MiniERP.WinForms\Forms\StokKartiEkleFormNew.cs", "C#", -8, -1, -1, -10
"c:\Users\kursa\source\repos\MİniERP2_form_siifirdan\MiniERP.WinForms\Forms\StokTransferiForm.cs", "C#", 36, 2, 1, 39
"c:\Users\kursa\source\repos\MİniERP2_form_siifirdan\MiniERP.WinForms\Forms\StokYonetimiForm.cs", "C#", 10, 0, 0, 10
"Total", "-", 7925, 1298, 581, 9804